1111111111111111111111111111111111
1E0000000000000C00000C000000000001
1010010100100000101001000000010101
1010010010101010001001000000010101
100000000C00C000000000000000000011
1010010010101010001111011111110101
1010010010101010001001000000010111
1010010010101010001001000000010101
1010010010101010001001000000011001
1010010010101010001001000000010101
1010010010101010001001000000010101
1010010010101010001001000000010101
1010010010101010001001000000010101
1010010010101010001001000000011101
101001001010101000100100P000010101
1111111111111111111111111111111111