1111111111111
1PC10E00000C1
1C00010111001
1011C00C00001
1111111111111