11111111111111111111111111111
11000000000000111000000000001
10100100101010100010010000C01
1000000000000000000001000E0P1
11111111111111111111111111111
