11111111111111111111
10C001C1000000000001
10010100100010000C01
1000000000001000E0P1
11111111111111111111
