11111111111111111111111111111
110000000000001P1000000000001
10100100101010100010010000001
10100100101010100010010000001
10100100101010100010010000001
1E0000000000C0000000000000001
11111111111111111111111111111